e2eg : ear to ear grin
ly : love you
nbs : no bull shit
dupe : duplicate
wam : wait a minute
p2u4uraqtp : peace to you for you are a cutie pie
lic : like i care
bobfoc : body off baywatch face off crimewatch
gdw : grin duck and wave
kia : killed in action
yvw : you are very welcome
nfw : no fucking way  no feasible way
wut :  what
soh : sense of humor
yiwgp : yes i will go private
dr : did not read
pip : peeing in pants
blzrd : blizzard
sf : surfer friendly  science fiction
fng : fucking new guy
bz : busy
187 : murder/ homicide
csabr : continued success and best regards
cs&f : cute sexy & funny
bbamfic : big bad ass mother fucker in charge
upod : under promise over deliver
nff : no fucking fair
omfg : oh my fucking god
kysoti : keep your stick on the ice
vm : voice mail
kibo : knowledge in bullshit out
ym : your mother
srlb : spoiled rotten little brat
bi5 : back in five
glng : good luck next game
sfete : smiling from ear to ear
bol : best of luck
dqmot : so not quote me on this
dwf : divorced white female
^^ :  read line or message above
j4g : just for grins
lonh : lights on nobody home
dh : dear husband
bme : based on my experience
bi : business intelligence
aayf : as always your friend
mml : made me laugh
kmfha : kiss my fat hairy ass
sry : sorry
sq : square
pots : plain old telephone system  pat on the shoulder
fbow : for better or worse
nfbsk : not for british school kids
ob : obligatory
sk8rboi : skater boy
onid : oh no i did not
rotm : right on the money
x-1-10 :  exciting
anfscd : and now for something completely different
ijs : i am just saying
sdmb : sweet dreams, my baby
c/s : change of subject
gfymf : go fuck yourself mother fucker
udi : unidentified drinking injury
nwot : new without tags
foc : free of charge
nqocd : not quite our class dear
awc : after while crocodile
ta : thanks again
4col : for crying out loud
bcnu : be seeing you
npc : non-playing character
dbbswf : dream boat body shipwreck face
dm : direct message
hoas : hold on a second
dusl : do you scream loud?
urz : yours
ed : erectile dysfunction
lmtcb : left message to call back
kir : keep it real
iitywimwybmad : if i tell you what it means will you buy me a drink
b&e : breaking & entering
bdc : big dumb company
bbiaw : be back in a while
eta : estimated time of arrival
pfa : please find attached
otasoic : owing to a slight oversight in construction
dp : domestic partner
afaiaa : as far as i am aware
14 : it refers to the fourteen words
4eae : forever and ever
bj : blow job
hmfic : head mofo in charge
lqtm : laughing quietly to myself
nb : nota bene
botec : back of the envelope calculation
u-l : you will
z : said
bibi : bye bye
pm : personal message  private message
imco : in my considered opinion
innw : if not now when?
phat : pretty hot and tempting
mob : mobile
r u there? : are you there?
gal : get a life
tiad : tomorrow is another day
txt : text
botl : bra on the loose
oa : online auctions
b-day : birthday
laoj : laughing at own joke
b4n : bye for now
esmf : eat shit mother fucker
cmiw : correct me if i am wrong
zot : zero tolerance
btwitiailwu : by the way i think i am in love with you
gd/r : grinning, ducking, and running
imnsho : in my not so humble opinion
lnt :  lost in translation
cto : check this out
pimpl : peeing in my pants laughing
f2t : free to talk
muah : multiple unsuccessful attempts  humor
kity : keep it to yourself
pza : pizza
itma : it is that man again
rotgl : rolling on the ground laughing
esfoad : eat shit fuckoff and die
kmt : kiss my tushie
ynk : you never know
mlm : giving the digital middle finger
tic : tongue in cheek
tsia : this says it all
bcos : because
ays : are you serious?
ldttwa : let is do the time warp again
fubar : fucked up beyond all recognition
mgb : may god bless
bbfbbm : body by fisher brains by mattel
plztlme : please tell me
hhfo : hell has frozen over
swak : sealed  with a kiss
ibtd : i beg to differ
mkay :  mmm, okay
atst : at the same time
imhif : i move how i feel
swit : sit and sweat
p : partner
hdgfs : how does get fucked sound?
ucwap : up a creek without a paddle
abc : always be creating  collaborating  communicating
dnc : does not compute
juadlam : jumping up and down like a monkey
oz : australia
s4l : spam for life
fsu : fuck shit up
yyssw : yeah yeah sure sure whatever
smem : send me e-mail
vwp : very well played
fomof : fear of missing out on football
sfaik : so far as i know
f2p : free to play
iat : i am tired
cico : coffee in coffee out
bioya : blow it out your ass
wyfm : would you fuck me?
tstb : the sooner the better
suitm : see you in the morning
afgo : another fucking growth opportunity
iaits : it is all in the subject
sal : such a laugh
ign : i  got nothing
tnstaafl : there is no such thing as a free lunch
iml :  i love you
emfji : excuse me for jumping in
s^ : what is up?
b2d : business-to-distributor
bta : but then again  before the attacks
yeppies : young experimenting perfection seekers
byob : bring your own bottle  bring your own beer
twiwi : that was interesting wasn't it?
kewl : cool
lmao : laughing my ass off
dd : due diligence
posc : piece of shit computer
mfd : multi-function device
r : are
mofo : mother fucker
2g2b4g : too good to be forgotten
tc : take care
afu : all fucked up
slm : see last mail
gos : gay or straight
pmji : pardon my jumping in
bwo : black white or other
h/p : hold please
lwu : laughing with you
sup : what is up?
aisb : as i said before
dyfi : did you find it?
sobt : stressed out big time
omb : oh my buddha
tbh : to be honest
iono : i so not know
yllo : you lie like obama
milf : mother i would like to fuck
lfg : looking for group
afagay : a friend as good as you
gr8 : great
**// : wink wink nudge nudge
msnuw : mini-skirt no underwear
dyor : do your own research
pkmn : pokemon
dwpkotl : deep wet passionate kiss on the lips
ryfm : read your friendly manual
flotus : first lady of the united states
mva no pi : motor vehicle accident with no personal injury
mins : minutes
tla : three letter acronym
wcmtsu : we cannot make this shit up
dbeyr : so not believe everything you read
rmma : reading my mind again
b@u or bak@u : back at you
ygm : you have got mail
bbiaf : be back in a few
l33t : leet,  'elite'
bioiya : break it off in your ass
rs : runescape
ghm : god help me
aoas : all of a sudden
acqstn : acquisition
hi5 : high five
bbbg : bye bye be good
iiwm : if it were me
b2e : business-to-employee
ncg : new college graduate
gwi : get with it
yhm : you have mail
iss : i said so  i am so sure
motd : message of the day
fah : fucking a hot
hoic : hold on i am coming
w/r/t : with regard to
pebcak : problem exists between chair and keyboard
hbic : head bitch in charge
bbfn : bye bye for now
igwst : it goes without saying that
ooo : out of office
goi : get over it
arg : argument
cbm : covered by medicare
cqrt : security
otp : on the phone
merp : modestly enlightened rich people
tb : titty bar
ysic : why should i care?
adr : address
cam : camera
yhbt : you have been trolled
cot : circle of trust
sbi : sorry about it
nmhjc : not much here just chilling
abu : all bugged up
atsits : all the stars in the sky
lmbpo : laughing my booty pop off
ily : i love you
woa : work of art
gr2br : good riddance to bad rubbish
bc : because
idgara : i so not give a rats ass
ttmf : ta ta mofo
wtfdyjs : what the fuck did you just say?
6y : sexy
adih : another day in hell
ioh : i am outta here
ltod : laptop of death
aaaaa : american association against acronym abuse
aymm : are you my mother
fyeo : for your eyes only
isyals : i will send you a letter soon
nfm : none for me / not for me
brics : brazil russia india china south africa
bd : big deal  baby dance  brain drain
pans : pretty awesome new stuff
pdq : pretty darn quick
nitl : not in this lifetime
bb4n : bye bye for now
wim : woe is me
hua : heads up ace  head up ass  heard understood acknowledged
wayd : what are you doing?
oth : off the hook
a2d : agree to disagree
jfgi : just *freaking* google it
831 : i love you
dwm : divorced white male
tos : terms of service
2moro : tomorrow
20 : location
rts : read the screen
gtgp : got to go pee
oof : out of facility
afz : acronym free zone
ptfo : pass the *freak* out
ar : action required
gg : good game  gotta go  giggling
tisnf : that is so not fair
kfy : kiss for you
k4y : kiss for you
shmily : see how much i love you
ihy : i heart you  i hate you
pcm : please call me
cula : see you later alligator
prolly : probably
joott : just one of those things
jdmj : just doing my job
idiftl : i did it for the lulz
wwjd : what would jesus do?
jsu : just shut up
nltbro : not likely to be run over
awhfy : are we having fun yet?
hnl : hole 'nother level
wabom : what a bunch of malarkey
faf : find a friend
tanked :  owned
iyfd : in your fucking dreams
sk8er : skater
wt : without thinking  what the  who the
wlmirl : would like to meet in real life
mkop : my kind of place
dord : department of redundancy department
aar : at any rate
cxo : chief insert title here officer
wyham : when you have a minute
bhimbgo : bloody hell i must be getting old
ftrf : fuck that is really funny
bhag : big hairy audacious goal
ni4ni : an eye for any eye
frzn : freezing
hagn : have a good night
yf : wife
ot : off topic
ctfd : calm the fuck down
lmk : let me know
tayn : thinking about you now
j4f : just for fun
otc : over the counter
ttly : totally
bop :  bind on pickup
ifab : i found a bug
sohf : sense of humor failure
sia : say it again
bosmkl : bending over smacking my knee laughing
cp : chat post
bolo : be on the look out
gpoy : gratuitous picture of yourself
fe : fatal error
dink : double incomes no kids
noob : newbie no experience
rtwfq : read the whole fucking question
nascar : non-athletic sport centered around rednecks
dv8 : deviate
fu : *freak* you
ruh : are you horny?
idc : i so not care
dga : so not go anywhere
wrudatm : what are you doing at the moment?
hagd : have a great day
aon : apropos of nothing
2b : to be
imezru : i am easy are you?
g4i : go for it
yhl : you have lost
8 : ate
nvr : never
tts : text to speech
nmjc : nothing much, just chilling
tttt : to tell the truth
pst : please send tell
8t : it
ityk : i thought you knew
foaf : friend of a friend
tht : think happy thoughts
qsl : reply
diku : do i know you?
myob : mind your own business
b8 : bait
phb : pointy haired boss
yajwd : you ain't just whistling dixie
ctn : cannot talk now
mtsbwy : may the schwartz be with you
chillaxin : chilling and relaxing
wnohgb : where no one has gone before
s2u : same to you
wtfe : what the *freak* ever
lmp : lick my pussy
tt : big tease
loomm : laughing out of my mind
lore : learn once repeat everywhere
dn : down
difbet : what is the difference between
csn : chuckle snicker grin
bbt : be back tomorrow
wwult : what would you like to talk about
taumualu : thinking about you miss you always love you
jm2c : just my 2 cents
jt : just teasing
ttyafn : talk to you awhile from now
i&i : intercourse & inebriation
sk8r : skater
wtf : what the fuck
afj : april fools joke
wycm : will you call me?
its a d8 : it is a date
ybysa : you bet your sweet ass
bil : brother-in-law  boss is listening
mmk : mmm ok
wtg : way to go
lmnk : leave my name out
yaun : yet another unix nerd
iwawo : i want a way out
pwcb : person will call back
iggp : i gotta go pee
gd&rf : grinning ducking and running fast
womobijo : working mother with a big job
tabooma : take a bite out of my ass
nstlc : need some tender loving care
dunno : i so not know
loml : love of my life
wc : world cup
sat : sorry about that
ome : oh my evolution
gdr : grinning, ducking, and running
qik : quick
lysouaq : learn your shit or up and quit
rtntn : retention
mhbfy : my heart bleeds for you
webo : webopedia
ik : i know
gidk : gee i so not know
bffl : best friends for life
k8t : katie
mrm : men is rights movement
cr8 : create
aimb : as i mentioned before
rthx :  thanks for the rt
lagnaf : lets all get naked and fuck
dityid : did i tell you i am distressed
bplm : big person little mind
lolwuss : laugh out loud with unintentional snort sound
cmiiw : correct me if i am wrong
proggy :  computer program
fos : full of shit
amrmtyfts : all my roommates thank you for the show
g4n : good for nothing
suakm : shut up and kiss me
ruup4it : are you up for it?
inal : i am not a lawyer
tank :  really strong
jas : just a second
usbca : until something better comes along
dfla : disenhanced four-letter acronym
i-d-l : ideal
q : queue  question
toon : short for cartoon
iirc : if i remember correctly  if i recall correctly
imfkd^ : i am fucked up
tyt : take your time
yw : you are welcome
w@ : what?
lmfao : laughing my fucking ass off
evre1 : every one
kybc : keep your bum clean
ymak : you may already know
ltns : long time no see
cbf : cannot be fucked
wafb : what a fucking bitch
vc : venture capital
txt msg : text message
sgtm : sounds good to me
unt : until next time
soic : so i see
cy : calm yourself
nll : nice little lady
fmltwia : fuck me like the whore i am
unf : universal noise of fucking
byoh : bat you on  head
fyifv : fuck you i am fully vested
ofap : old fart at play
btoiya : be there or it is your ass
rfr : really fucking rich
iasap4u : i always say a prayer for you
syy : shut your yapper
fc'ingo : for crying out loud
cyep : close your eyes partner
altg : act locally think globally
roflmaoastc : rolling on floor laughing my ass off and scaring the cat
ura* : you are a star
ggpbl : gotta go pacemaker battery low
ddg : drop dead gorgeous
sihth : stupidity is hard to take
pmfi : pardon me for interrupting
botoh : but on the other hand
glg : good looking girl
mfi : mad for it
wru : where are you?
grrr : growling
y? : why?
degt : so not even go there
jw : just wondering
pld : played
dwwwi : surfing the world wide web while intoxicated
tdm : too darn many
mtsitn : more than ships in the night
iynaegbtm : if you need anything else get back to me
slom : sticking leeches on myself
troo : true
un4tun8 : unfortunate
dtc : deep throaty chuckle
iwbni : it would be nice if
roflcopter : rolling on floor laughing and spinning around
ctmq : chuckle to myself quietly
rly : really
lhos : lets have online sex
aatk : always at the keyboard
ul : upload
limt : laugh in my tummy
facepalm : used to represent the gesture of smacking your forehead with your palm to express embarrassment or frustration
tahitmots : there is a hole in the middle of the sea
omma : oh my aching ass
fdff : falling down fucking funny
kmim : keep me in mind
bib : boss is back
mws : my wife says
bcbg : bon chic bon genre  belle cul belle geulle
sapfu : surpassing all previous foul ups
bmw : b*tch moan whine
dw2h : so not work too hard
tbl : text back later
sn : side note
cld : cold
2mi : too much information
hhos : ha ha only serious
ltf : lick the floor
bsbd&ne : book smart brain dead & no experience
jdi : just do it
hwga : here we go again
dirft : do it right the first time
tafn : that is all for now
auntm : and u know this man
atw : all the web around the web all the way at the weekend
bbmfic : big bad mother fucker in charge
pbj : peanut butter and jelly  pretty boy jock
tf : too funny
snl : same night lay
tobal : there oughta be a law
iitm : it is in the mail
tsr : totally stuck in ram  totally stupid rules
lhsx : lets have sex
rbay : right back at you
lult : love you long time
mitin : more info than i needed
smd : suck my dick
plos : parents looking over shoulder
atab : ain't that a bitch
wabi : what a bright idea
awol : absent without leave
bfaw : best friend at work
lolpmp : laugh out loud peed my pants
ycht : you can have them
wysiwyg : what you see is what you get
iaal : i am a lawyer
yy4u : too wise for you
rumof : are you male or female?
mc : merry christmas
wtm : who is the man?
rotflmfao : rolling on the floor laughing my fucking ass off
iitywybmad : if i tell you will you buy me a drink
jafo : just another fucking onlooker
nimq : not in my queue
tlk2ul8r : talk to you later
darfc : ducking and running for cover
mez :  mesmerize
pc : personal computer
459 : i love you
ftr : for the record
s3<==8 : screwed in the ass
rl : real life
tobg : this oughta be good
da : there
howru : how are you
aak : asleep at keyboard
gl : have fun
hf : good luck
oic : oh i see
ig2r : i got to run
brd : bored
ltio : laughing til i orgasm
snny : sunny
lifo : last in first out
gle : good luck everyone
bion : believe it or not
gn8 : good night
xxcc : kiss kiss hug hug
tg4a : thank god for acronyms
ursai : you are such an idiot
twu : that is what is up
rtms : read the manual, stupid
vrbs : virtual reality bull shit
eak : eating at keyboard
txt im : text instant message
wndy : windy
fav : favorite
thnq : thank-you
nab : not a blonde
dwym : does what you mean
lsv : language sex violence
iaym : i am your master
wygam : when you get a minute
udm : you are the man
ims : i am sorry
glyasdi : god loves you and so do i
vsc : very soft chuckle
hak : hugs and kisses
tnc : tongue in cheek
iwiwu : i wish i was you
wgaca : what do you think?
hau : how about you?
btdtgts : been there done that got the t-shirt
boyf : boyfriend
asl : age/sex/location
fb : fuck buddy  facebook
dinr : dinner
ibt : in between technology
xoxozzz : hugs and kisses and sweet dreams
nbfab : not bad for a beginner
2mor : tomorrow
hhtyay : happy holidays to you and yours
lpos : lazy piece of shit
duna : so not use no acronyms
wyslpg : what you see looks pretty good
jtol : just thinking out loud
sd : sweet dreams
galhim : get a load of him
syt : see you tomorrow
mfic : mother fucker in charge
gws : get well soon
14aa41 : one for all and all for one
ftl : faster than light
dilligas : do i look like i give a shit
eol : end of life
b9 : boss is watching
pmp : peeing my pants
btyc : better than you can
jhomf : just helping out my friend
wayf : where are you from?
aashta : as always, sheldon has the answer
taf : that is all folks
wcw : woman crush wednesday
kbd : keyboard
tmb : text me back
fif : fuck i am funny
tbd : to be determined
n/t : no text
tah : take a hike
nino : nothing in nothing out  no input no output
l&r : love and respect
rn : right now
swmbo : she who must be obeyed
muah or mwah : the sound of a kiss
ianae : i am not an expert
asla : age/sex/location/availability
sicl : sitting in chair laughing
tgif : thank god it is friday
bcoz : because
gomb : get off my back
kmba : kiss my black ass
ntim : not that it matters
r&d : research & development
mbn : must be nice
cio : check it out  chief information officer / chief internet officer
wawa : where are we at?
ima : i might add
ggp : gotta go pee
fyi : for your information
ditto : same here
wtfo : what the *freak* ?, over.
fo : fuck off
gfi : go for it
ace : access control entry
hpoa : hot piece of ass
lhso : let is have sex online
iae : in any event
ntb : not too bright
bgf : best girlfriend
gbtw : get back to work
hsiab : haven't seen it all before
imowha : i made out with him her anyway
sogop : shit or get off the pot
otb : off to bed
rtfm : read the fucking manual
foad : fuck off and die
w/o : without
siuya : shove it up your ass
fouo : for official use only
idbi : i so not believe it
witp : what is the point?
asig : and so it goes
jk  : just kidding
lemeno : let me know
dbabai : so not be a bitch about it
ljbf : let is just be friends
ryo : roll your own
wthin : what the hell is next
53x : sex
tsob : tough son of a b*tch
v : very
kmp : keep me posted
bwtm : but wait there is more
luser : loser
hawtlw : hello and welcome to last week
bbw : big beautiful woman  big black woman
iac : in any case  i am confused  if anyone cares
swat : scientific wild *butt* guess
maya : most advanced yet accessible
bbiab : be back in a bit
sosad : same old song and dance
rotfl : rolling on the floor laughing
pir : parent in room
bf : boyfriend  best friend
h-bday : happy birthday
tripdub : www
b2b : business-to-business
piaps : pig in a pant suit
hx : history  hospital
btn : better than nothing
pncah : please no cursing allowed here
tyso : thank you so much
ooak : one of a kind
x-i-10 : exciting
mo : move on
b2w : back to work
sys : see you soon
t&c : terms & conditions
sir : strike it rich
eadd : entrepreneurial attention deficit disorder
iagtkom : i ain't got that kind of money
aft : about fucking time
ost : on second thought
fla : four letter acronym
dey : they
trdmc : tears running down my cheeks
oyo : on your own
1dr : i wonder
ror : raffing out roud
ut2l : you take too long
sro : standing room only
88 : hugs and kisses
omwt : on my way too
nta : not this again
s2s : sorry to say
gmab : give me a break
tk : to come
ywia : you are welcome in advance
182 : i hate you
ucmu : you crack me up
cul : see you later
mvto : thank you
natc : not a text conversation
kmuf : kiss me you fool
hbib : hot but inappropriate boy
eft : electronic funds transfer
sow : speaking of which  statement of work
ime : in my experience
lfd : left for day
srsly : seriously
wrud : what are you doing?
ocd : obsessive compulsive disorder
doe : depends on experience
sip : skiing in powder
gj : good job
fye : for your edification
ttfn : ta ta for now
wag : wild ass guess  wives and girlfriends
asafp : as soon as fucking possible
shhh : quiet
gth : go to hell
fc : fingers crossed
btyd : better than you do
bon : believe it or not
tcb : trouble came back  taking care of business
bao : be aware of
bamf : bad ass mother fucker
prw : parents are watching
lm46 : let is meet for sex
ks : kill stealer
sanm : starting a new message
waj : what a jerk
02 : your two cents worth also seen as m.02
wirld : world
nfc : not favorably considered  no fucking chance
tko : technical knock out
ab : ass backwards  ah bless
fubb : fucked up beyond belief
lmso : laughing my socks off
pcmcia : people cannot memorize computer industry acronyms
iwalu : i will always love you
ybic : your brother in christ
mmyt : mail me your thoughts
iir : if i remember  if i recall
kb : keyboard
kypo : keep your pants on
mp : mana points
acd : alt control delete
tpiyp : to put in your prayers
olo : only laughed once
w/b : welcome back
iyq : i like you
99 : parent is no longer watching
gawd : god
nttawwt : not that there is anything wrong with that
mnsg : mensaje
tjbnj : this job beats no job
ikaloplt : i know a lot of people like that
nvm : never mind
sed : said enough darling
ayk : as you know
pebcac : problem exists between chair and computer
kotl : kiss on the lips
crdtchck : credit check
gfr : grim file reaper
rlf : real life friend
sbia :  standing back in amazement
ibtl : in before the lock
@teotd : at the end of the day
vsf : very sad face
sin : stop it now
nm, u : not much you?
b& : banned
gdi : god damn it  god damn independent
furtb : filled up and ready to burst
gsw : gun shot wound
wkewl : way cool
nh : nice hand
cil : check in later
l8rg8r : later, gator
gts : google that shit
qfi : quoted for idiocy
dts : so not think so
ee : employees
ees : employee
iykwim : if you know what i mean
nifoc : nude in front of the computer
sorg : straight or gay
poak : passed out at keyboard
sicnr : sorry, i could not resist
ootb : out of the box  out of the blue
noa : not online anymore
id10t : idiot
imoo : in my own opinion
bb : be back  buzzard breath  blessed be
tmsaisti : that is my story and i am sticking to it
h2s : here to stay
ryb : read your bible
fimh : forever in my heart
jho : just helping out
onna : oh no not again
j5m : just five minutes
advd : advised
ycmtsu : you cannot make this shit up
potato : person over thirty acting twenty one
snnshwrs : sun showers
tqm : total quality management
fupa : fat upper pussy area
iyd : in your dreams
x! :  a typical woman
p-za : pizza
wk : week
eos : end of show
sbug : small bald unaudacious goal
pwp : plot what plot?
rino : republican in name only
xlr8 :  faster or going faster
iaaa : i am an accountant
lmta : like minds think alike
afw : away from window
ga : go ahead  good afternoon
pdh : pretty darn happy
bitd : back in the day
iwfu : i wanna fuck you
tam : thanks a million
nesec : any second
ttyob : tend to your own business
sbta : sorry being thick again
rpg : role playing games
wtfh : what the fucking hell
ttyawfn : talk to you a while from now
joml : jesus on the main line
tisnc : this is so not cool
yg : young gentleman
qft : quoted for truth  quit fucking talking
ihni : i have no idea
fomo : fear of missing out
goyhh : get off your high horse
idgi : i so not get it  i so not get involved
f2f : face-to-face a.k.a. face time
ewg : evil wicked grin
atwd : agree that we disagree
gbh : great big hug
bw : best wishes
voip : voice over internet protocol
gfn : gone for now
toj : tears of joy
zh : sleeping hour
oos : out of stock
css : counter-strike source
ers2 : eres tz / are you
wrk : work
bdsm : bondage dominance sadism masochism
admin : administrator
lttic : look the teacher is coming
tbag : process of disgracing a corpse, taunting a fragged/killed player
q2c : quick to cum
wambam : web application meets brick and mortar
buhbye : bye
cu2 : see you
i2 : i too
bitmt : but in the meantime
pu : that stinks
hbb : hip beyond belief
lbs : laughing but serious
qs : quit scrolling
btdt : been there done that
pda : personal digital assistant  public display of affection
dstr8 : damn straight
cfv : call for vote
w/end : weekend
vgg : very good game
aitr : adult in the room
ibtc : itty bitty titty committee
wlu : wicked love you
hrcn : hurricane
abk : always be knolling
bm : byte me
ne-wayz : anyways
btw : by the way  bring the wheelchair
kiss : keep it simple stupid
cumid : see you in my dreams
wak : what a kiss
aydy : are you done yet?
xoxoxo : hugs & kisses
bn : been  being
imfao : in my fucking arrogant opinion
h4u : hot for you
inmp : it is not my problem
huh : what
thx : thanks
nimy : never in a million years
iso : in search of
affa : angels forever, forever angels
tsra : two shakes of a rat is ass
omw : on my way  oh my word
runts : are you nuts?
tff : too *freaking* funny
r8 : rate
lhm : lord have mercy
hny : happy new year
gle1 : good luck everyone
smaim : send me an instant message
coh : city of heroes
bo : bug off  body odor
sthu : shut the hell up
lir : let it rest
ah : at home
boaisy : bend over and i will show you
420 : marijuana
moos : member of the opposite sex
inc :  incoming
tansit : there is a new sheriff in town
lpc : lead pipe cinch
jj  : just joking
pos : parent over shoulder  piece of shit
stby : sucks to be you
gl2u : good luck to you
jad : just another day
mooc : massive open online course
lmirl : let is meet in real life
ibiwisi : i will believe it when i see it
afaik : as far as i know
tl : too long
wotd : word of the day
kt : katie
nbg : no bloody good
bbsd : be back soon darling
basor : breathing a sigh of relief
rotglmao : rolling on the ground laughing my ass off
njapf : not just another pretty face
aysos : are you stupid or something
h-mday : happy mother is day
mamil : middle aged men in lycra
sfla : stupid four letter acronym
lumumi : love you miss you mean it
idky : i so not know you
dwbh : so not worry be happy
tsif : thank science it is friday
bdbi5m : busy daydreaming back in 5 minutes
cicyhw : can i copy your home work
sts : so to speak
selfie : a photo that is taken of oneself for social media sharing
wmhgb : where many have gone before
gist : great ideas for starting things
kkk : "over" as in waiting for your reply
bf2 : battlefield 2
gna : good night all
wtdb : what is the difference between
nfi : no fucking idea
t2go : time to go
gob : game on b*tcheeez
keya : i will key you later
ilu : i love you
j/c : just checking
tps : that is pretty stupid
spto : spoke to
musm : miss you so much
sc : stay cool
gns : gangnam style
ott : over the top
fawc : for anyone who cares
dfu : so not fuck up
pso : product superior to operator
ptiypasi : put that in your pipe and smoke it
mihap : may i have your attention please
yglt : you are gonna love this
soiar : sit on it and rotate
ltr : long term relationship
waci : what a cool idea
grwg : get right with god
dmi : so not mention it
wuzup : what is up?
4e : forever
lo : hello
vry : very
pibkac : problem is between keyboard and chair
otoh : on the other hand
iottco : intuitively obvious to the casual observer
ctfo : come the fuck on
dur : do you remember
crbt : crying real big tears
jlmk : just let me know
ux : user experience
awgthtgtta : are we going to have to go through this again
lfu : life"s fucked up
ltd : living the dream
tta : tap that ass
ooto : out of the office
pds : please so not shout
iiio : intel inside idiot outside
bthoom : beats the heck out of me
gahoy : get a hold of yourself
swl : screaming with laughter
u4e : yours forever
ff : friends forever
tingtes : there is no gravity the earth sucks
blbblb : back like bull brain like bird
1tg, 2tg :  number of balls needed for win
iykwimaityd : if you know what i mean and i think you do
ihno : i have no opinion
soab : son of a *b*
hnti : how nice that/this is
yarbwyr : you are a right bleed'n wanker you are
dnr : dinner
mu : miss u
waboc : what a bunch of crap
wtg4a\\%/ : want to go for a drink
ycliu : you can look it up
yati : you are a total idiot
ni : not interested
tfm : thanks from me
iwsn : i want sex now
d46? : down for sex?
c : see
glgh : good luck and good hunting
kcco : keep calm & carry on
ya : yet another  you  your
crb : come right back
hbo : helping a brother out
nmu : not much you?
byow : build your own website  bring your own wine
t2ul : talk to you later
stm : spank the monkey
atsl : along the same line
wl : whatta loser
idts : i so not think so
iyss : if you say so
lib : lying in bed
bytme : better you than me
w4m : women for men
555 : sobbing, crying.
emea : europe the middle east and africa
b2g : business-to-government
iit : is it tight?
lya : love you all
cyl : see you later
fear : forget everything and run  face everything and recover
sol : shit out of luck  sooner or later
ngb : nearly good bridge
tmtowtdi : there is more than one way to do it
gtk : good to know
nirok : not in reach of keyboard
www : world wide web
yaa : yet another acronym
cra cra : slang term  crazy
lm4a~##zzzz> : let is meet for a joint
byoc : bring your own computer
iaad : i am a doctor
lotr : lord of the rings
s'ok :  it'
cyal8r : see you later
dba : doing business as
slaw : sounds like a winner
adidas : all day i dream about sex
iuri : if you are interested
pic : picture
wyt : whatever you think
ibk : idiot behind keyboard
tanstaafl : there ain't no such thing as a free lunch
btsoom : beats the shit out of me
bg : be good
love : lots of voluntary effort
nub : new person to a site or game
awniac : all we need is another chair
aeap : as early as possible
siup : suck it up pussy
tku4uk : thank you for your kindness
ymbkm : you must be kidding me
dyac : damn you auto correct
ql : quit laughing
ly4e : love you forever
cu46 : see you for sex
atb : all the best
nwo : no way out
niywfd : not in your wildest fucking dreams
?^ : hook up?
bic : butt in chair
ll : livin' large
tmot : trust me on this
mfrc : my fingers are crossed
scnr : sorry could not resist
doin : doing
lolwtf : laughing out loud  what the *freak*?
qq : quick question  cry more
ttul : talk to you later
ldo : like, duh obviously
sl : second life
nmh : not much here
gol : giggling out loud
fya : for your amusement
we : whatever
h4xx0r : hacker  to be hacked
wyrn : what is your real name?
psp : playstation portable
cyo : see you online
hbastd : hitting bottom and starting to dig
fbks : failure between keyboard and seat
? : i have a question
gok : god only knows
ab/abt : about
pls : please
ymybnycsii : you made your bed now you can sleep in it
saia : stupid asses in action
myl : mind your language
gl : good luck  get lost
lwys : look what you started
lolz : lots of laughs
bt : byte this
ikwym : i know what you mean
ditr : dancing in the rain
tptb : the powers that be
ysan : you are such a nerd
soe : start of exams
nts : note to self
bih : burn in hell
hppo : highest paid person in office
ygbsm : you gotta be shiting me
fatm : foaming at the mouth
hcc : holy computer crap
ifh8tabx : i fucking hate this acronym bollocks
iycssnasdsaaa : if you canâ€™t say something nice about someone donâ€™t say anything at all
rip : rest in peace
tau : thinking about u
cta : call to action
dltbbb : so not let the bed bugs bite
m4w : men for women
ttiot : the truth is out there
ots : on the scene  on the spot  off the shelf
bff : best friends forever  best friend is funeral
cm : call me
n/a : not applicable  not affiliated
laq : lame ass quote
isagn : i see a great need
bfd : big fucking deal  big fucking disaster
<33 :  heart or love
hhok : ha ha only kidding
disto : did i say that outloud?
effin : fucking
lf : let is fuck
emsg : e-mail message
nnww : nudge nudge wink wink
ita : i totally agree
kdfu :  cracking  *freak* up
wymyn : women
tmsgo : too much shit going on
fym : for your misinformation
ma : mature audience
urtm : you are the man
khyf : know how you feel
diaf : die in a fire
wkd : weekend
cs : computer science
ttyl : talk to you later  type to you later
bhl8 : be home late
ily2 : i like/love you too
issygti : i am so sure you get the idea
nqa : no questions asked
lh6 : letâ€™s have sex
i <3 u : i love you
2bz4uqt : too busy for you cutey
clk : click
msta : must see to appreciate
btycl :  'bootycall'
wtb : want to buy
twhe : the walls have ears
wtshtf : when the shit hits the fan
b4 : before
hiooc : help i am out of coffee
ne1er : anyone here?
afpoe : a fresh pair of eyes
htb : hang the bastards
stys : speak to you soon
nsa : no strings attached
tpc : the phone company
namailu : not as much as i love you
ne14kfc : anyone for kfc?
ybf : you have been fucked
hntw : how nice that was
gmv : got my vote
poms : parent over my shoulder
wdalyic : who died and left you in charge?
ldr : long distance relationship
itm : in the money
tm : trust me
pnattmbtc : pay no attention to the man behind the curtain
ltlwdls : let is twist like we did last summer
ya yaya : yet another ya-ya
ggy : go google yourself
ba : bad *a*
ion : index of names
idta : i did that already
s4b : shit for brains
kwsta : kiss with serious tongue action
e123 : easy as one two three
bnf : big name fan
fyltge : from your lips to gods ears
ol : old lady
wrm : warm
prt : partial retweet  party
nyc : not your concern
pz : peace
qc : quality control
gratz : congratulations
etla : etla extended three-letter acronym
mcm : man crush monday
yafiygi : you asked for it you got it
loa : list of acronyms
bbq : bar-b-que  barbeque
d2d : developer-to-developer or day-to-day
ikyabwai : i know you are but what am i?
mlas : my lips are sealed
addr : address
po-mo : post-modern
are : acronym rich environment
ssif : so stupid it is funny
ee : electronic emission
gga : good game all
dwb : so not write back
c/p : cross post
dilligad : do i look like i give a damn
uok : are you ok?
jt  : just teasing
spk : speak
ss : so sorry
b&f : back and forth
iyo : in your opinion
im : instant messaging  immediate message
rme : rolling my eyes
rb@ya : right back at ya
nr : nice roll
bykt : but you knew that
ish : insert sarcasm here
aom : age of majority
ptp : pardon the pun
hugz : hugs
y2k : you are too kind
osif : oh shit i forgot
2u2 : to you too
gtrm : going to read mail
somy : sick of me yet
yaf : young angry female
aimp : always in my prayers
ssdd : same shit different day
cn : can
sot : short on time
pft : pretty *freaking* tight
bfg : big fucking gun
wknd : weekend
cas : crack a smile
every1 : everyone
viv : very important visitor
obe : overcome by events
sec : wait a second
frt : for real though
snag : sensitive new age guy
hfac : holy flipping animal crackers
fofl : falling on floor laughing
raf : random as fuck
aka : also known as
rci : rectal cranial inversion
fcs : first customer ship
qotd : quote of the day
edm : electronic document management  electronic dance movement
ficcl : frankly i could not care a less
uscwap : up shit creek without a paddle
m2ny : me too not yet
asaygt : as soon as you get this
myt : meet you there
issoys : i am so sick of your stuff  s***  stories
glawd : good luck and well done
hitaks : hang in there and keep smiling
r u da? : are you there?
g2cu : good to see you
jafs : just a fucking salesman
1432 : i love you too
nqt : newly qualified teacher
afc : away from computer
riyl : recommended if you like
kmk : kiss my keister
ug2bk : you have got to be kidding
iitlyto : if it is too loud you are too old
ko : knocked out
syl : see you later
wiiwii : well it is what it is
fogc : fear of getting caught
ytrnw : yeah that is right now what?
tgal : think globally act locally
nb4t : not before time
gwot : glorified waste of time
1nam : one in a million
plur : peace love unity respect
sii : seriously impaired imagination
cu : see you  cracking up
gjp : good job partner
wetsu : we eat this shit up
hhis : hanging head in shame
nmte : now more than ever
yr : yeah right  you  your
kmwa : kiss my white ass
mtla : my true love always
cuns : see you in school
zzzz : sleeping
sh^ : shut up
otl : out to lunch
ftbl : football
crap : cheap redundant assorted products
ousu : oh you shut up
rbtl : read between the lines
fub : fat ugly bastard
imu : i miss u
b : be
hub : head up butt
sj : strong jaws
har : hit and run
pyt : pretty young thing
rafo : read and find out
mhhm : uh huh  yeah
smao : sweating my ass off
wf : way fun
bmota : byte me on the ass
tanking :  owning
imtm : i am the man
pmfji : pardon me for jumping in
tot : tons of time
dkdc : so not know so not care
po : piss off
gd : good
dyhag : do you have a girlfriend
gm : good morning  good move
kk : kiss kiss  ok
hahaha : laughing
dyhab : do you have a boyfriend?
rtbs : reason to be single
ib : i am back
drcowoto : so not really care one way or the other
wyd : what you doing?
twss : that is what she said
taks : that is a knee slapper
rtrmt : retirement
grl : girl
omfglmaobbqrofl : oh my freaking god, laugh my ass off, owned, roll on floor spinning around i am so sad
sic : spelling is correct
bibo : beer in beer out
ok : okay
rfn : right *freaking* now
j/k : just kidding
wwsd : what would satan do?
eml : email me later
i h8 it : i hate it
pitmemboam : peace in the middle east my brother of another mother
fifo : first in first out
ibgybg : i will be gone you will be gone
btr : better
boctaae : but of course there are always exceptions
gtl : gym tan laundry
dps : damage per second
pdoma : pulled directly out of my ass
bsts : better safe than sorry
faq : frequently asked questions
qt : cutie  quiet
tisl : this is so lame
pto : paid time off
psa : public service announcement
lvm : left voice mail
wtmi : way too much information
.02 : my  two cents worth
cobras : come on by right after school
bioyn : blow it out your nose
sh : shit happens
g4c : going for coffee
esh : experience strength and hope
ne2h : need to have
banana : penis
lshitipal : laughing so hard i think i peed a little
bttt : back to the top  bump to the top
dftba : so not forget to be awesome
nlt : no later than
djm : so not judge me
lycylbb : love you see you later bye bye
mof : matter of fact
ty : thank you
caac : cool as a cucumber
werubn : where have you been
psos : parent standing over shoulder
ateotd : at the end of the day
cod : cash on delivery
lombard : lots of money but a right dick
afaiu : as far as i understand
ttksf : trying to keep a straight face
itigbs : i think i am going to be sick
dtrt : do the right thing
giwist : gee i wish i would said that
ilbl8 : i will be late
aaf : as a friend  always and forever
pl8 : plate
?4u : i have a question for you
bbc : big bad challenge
str8 : straight
mgmt : management
std : seal the deal save the date sexually transmitted disease stuff to do
bfe : bum fuck egypt
hbu : how bout you?
b/c : because
rut : are you there?
smb : suck my balls
afahmasp : a fool and his money are soon parted
pbem : play by email
mva w/pi : motor vehicle accident with personal injury
p3r50n : person
ooc : out of character  out of control
hih : hope it helps
wu : what is up
irl : in real life
pfc : pretty fucking cold
aoe : area of effect
figmo : fuck it got my orders
wsu : what say you?
ng : new game
dpup : so not poop your pants
vbl : visible bra line
damhikt : so not ask me how i know that
jk : just kidding
nigi : now i get it
fitb : fill in the blanks
kpc : keeping parents clueless
zerg : to gang up on someone
tpt : trailor park trash
ntymi : now that you mention it
g98t : good night
hhh : hip hip hooray
cc : carbon copy
eyc : excitable, yet calm
naz : name address zip
pmbi : pardon my butting in
qyb : quit your bitching
cmao : chortling my ass off
ycdbwycid : you cannot do business when your computer is down
tftf : thanks for the follow
bndn : been nowhere done nothing
ysyd : yeah sure you do
aisi : as i see it
lob : lying on bed
waw : waiter/actor/webmaster  what a whore
ptoyed : please turn off your electronic devices
ap : apple pie
aa : alcoholics anonymous
fdgb : fall down go boom
dem : them
irncot : i would rather not comment on that
b4u : before you
tomtb : taking off my training bra
ttthtfal : talk to the hand the face ain't listening
bitch : basically in the clear homey
ht : hi there  hat tip
tttka : time to totally kick ass
witw : what in the world
dyli : do you love it?
natch : naturally
wuz4dina : what is for dinner?
nsfw : not safe for work
gafl : get a fucking life
mt : empty  modified tweet
wwy : where were you?
ihaim : i have another instant message
cmon : come on
wop : with out papers
tna : temporarily not available
gfon : good for one night
sitcom : single income two children oppressive mortgage
oot : out of touch
nfs : need for sex  network file system
tisc : this is so cool
hoha : hollywood hacker
pwnt : owned
h&k : hugs and kisses
htnoth : hit the nail on the head
cmf : count my fingers
rtsm : read the silly manual
otf : on the floor  on the fone
mtmmfbwy : may the micky mouse force be with you
situbi : say it til you believe it
soi : self owning idiot
gmily : good morning i love you
aas : alive and smiling
imao : in my arrogant opinion
pp : personal problem
l2k : like to come
wep : weapon
ium : if you must
agkwe : and god knows what else
ax : across
tfthaot : thanks for the help ahead of time
eabos : eat a bag of shit
bwi : but what if
sdk : scottie doesn't know  software developer is kit
j00 : you
gap : got a pic?  gay ass people
rc : remote control
tsh : too stinkin' hot
nrn : no reply necessary
abta :  good-bye
glb : good looking boy
mr. :  child and his age. mr.3 would be a 3-year old son
urapita : you are a pain in the ass
ssa : ass backwards
diy : do it yourself
fft : food for thought
ptl : praise the lord
kc : keep cool
mih : make it happen
rny : rainy
puter : computer
rgr : roger
rys : read your screen
ygbk : you gotta be kidding
ooi : out of interest
ttbomk : to the best of my knowledge
sk8 : skate
bas : big 'butt' smile
wuw : what u  want?
ts : tough shit  totally stinks
rrq : return receipt requested
m8 or m8s : mate  mates
cuatsc : see you at the senior center
ppu : pending pick-up
swag : scientific wild ass guess
wyp : what is your problem?
iyaoyas : if you ain't ordinance you ain't shit
\m/ : heavy metal music
kma : kiss my ass
lywamh : love you with all my heart
rtm or rtfm : read the manual  read the fucking manual
na : nice ass
lok : lots of kisses
lerk : leaving easy reach of keyboard
ilum : i love you man
word : cool a.k.a. word up
wdymbt : what do you mean by that?
sfx : sound effects  stage effects
g2glys : got to go love ya so
ae : area effect
nimby : not in my back yard
csl : cannot stop laughing
sit : stay in touch
id : identification
bdoa : brain dead on arrival
u8 : you ate?
urw : you are welcome
plmk : please let me know
afaiui : as far as i understand it
uwm : you want me
lbug or lbig : laughing because you are gay  laughing because i am gay
1174 : nude club
iinm : if i am not mistaken
byki : before you know it
ys : you stinker
sjw : social justice warrior
shtf : shit hits the fan
tnt : til next time
c%d : could
gh : good hand
ihnc : i have no clue
p2p : parent to parent
lbh : let is be honest
obx : old battle axe
rotfluts : rolling on the floor laughing unable to speak
nimjd : not in my job description
xyl : ex-young lady,  wife.
sth : something
icbwicbm : it could be worse it could be me
idm : it doesn't matter
rmb : rings my bell
ldimedilligaf : look deeply into my eyes does it look like i give a fuck
usp : unique selling proposition
cos : change of subject   because
lmoa : left a message on your answering machine
ddas : so not do anything stupid
jam : just a minute
jsyk : just so you know
kab : kick ass bitch
ubs : unique buying state
pat :  patrol
wwno : walker wheels need oil
nalopkt : not a lot of people know that
gf : girlfriend
istm : it seems to me
lrf : little rubber feet
brbb : be right back *babe*
ur : you are
ftfoi : for the fun of it  for the fuck of it
wbs : write back soon
nwt : new with tags
ygg : you go girl
clm : career limiting move
jv :  joint venture
imml : i make myself laugh
lshmbh : laughing so hard my belly hurts
bwl : bursting with laughter
vat : value added tax
n-a-y-l : in a while
kudt : dutch for fucked up life
npic : nice picture
xlnt : excellent
lolo : lots of love
hoyew : hanging on your every word
qq  :  crying eyes
ps : post script
idtbbf : i deserve to be blown first
ottomh : off the top of my head
td2m : talk dirty to me
raebnc : read and enjoyed but no comment
lms : like my status  learning management system
cuatu : see you around the universe
dyofdw : do your own fucking dirty work
giar : give it a rest
pif : paid in full
alol : actually laughing out loud
afap : as far as possible
19 : 0 hand
pax : passengers
gnite : good night
tfds : that is for darn sure
nofi : no offence intended
yoyo : you are on your own
bsf : but seriously folks
adad : another day another dollar
ianadbipootv : i am not a doctor but i play one on tv
acpt : accept
aob : abuse of bandwidth
sotmg : short on time must go
mirl : meet in real life
fiiooh : forget it, i am out of here
;s : gentle warning, like hmm? what did you say?
musl : missing you shit loads
dbau : doing business as usual
ftasb : faster than a speeding bullet
ykwim : you know what i mean
wdym : what do you mean?
wad : without a doubt
t:)t : think happy thoughts
tfmiu : the fucking manual is unreadable
brh : be right here
no praw : no problem
motas : member of the appropriate sex
ymmd : you make my day  you made my day
afk : away from keyboard  a free kill
wafu : what a fuck up
t2ut : talk to you tomorrow
td&h : tall dark and handsome
tftu : thanks for the update
rotflol : rolling on the floor laughing out loud
lts : laughing to self
hsik : how should i know
stml : short term memory loss
ntw : not to worry
icbw : i could be wrong
ntbn : no text back needed
fw : forward
gfy : good for you  go fuck yourself  go find yourself
rm : remake
ijpmp : i just pissed my pants
os : operating system
tisnt : that is so not true
wuwh : wish you were here
pbook : phonebook
drib : so not read if busy
yttm : you talk too much
ttys : talk to you soon
awltp : avoiding work like the plague
2qt : too cute
xoxo : hugs and kisses
emrtw : evil monkey is rule the world
lkitr : little kid in the room
lik :  liquor
potus : president of the united states
wrt : with regard to  with respect to
lhu : let is hook up
ufn : until further notice
bwdik : but what do i know
jtou : just thinking of you
aiamu : and i am a monkey is uncle
cwot : complete waste of time
fcfs : first come first served
urws : you are wise
wadr : with all due respect
nthing : nothing
pfm : pure fucking magic
elol : evil laugh out loud
rbu : rainbows butterflies unicorns
cmap : cover my ass partner
y : why?
g2r : got to run
gowi : get on with it
yttl : you take too long
rsvp : repondez s'il vous plait
jmo : just my opinion
wdr : with due respect
jfh : just fuck her
i<3i : i love it
ru\\18 : are you under 18?
td : tower defense
wan2 : want to
h8ttu : hate to be you
<3 : heart
lolh : laughing out loud hysterically
tyfyc : thank you for your comment
h8 : hate
onud : oh no you did not
t@yl : talk at you later
nncimintfz : not now chief i am in the f ***in' zone
h-fday : happy father is day
filf : father i would like to fuck
unpc : unpolitically correct
omdb : over my dead body
swu : so what is up
aamoi : as a matter of interest
2 : to too two
jfi : just for information
gmtft : great minds think for themselves
oll : online love
tlgo : the list goes on
ttth : talk to the hand
gsoh : good sense of humor
idk : i so not know
e1 : everyone
pa : parent alert
mf : my friend
w3 : www
cofs : church of scientology
ttt : that is the ticket  to the top  thought that too
stfw : search the fucking web
lylb : love you later bye
nadt : not a damn thing
cunt : see you next time  cannot understand newest text
peep : people engaged and empowered for peace
icymi : in case you missed it
ij : inside joke
twtr : twitter
ggu2 : good game, you too
ijwtk : i just want to know
nhoh : never heard of him/her
wiu : wrap it up
cof$ : church of scientology
p&c : private & confidential
ffa : free for all
afaics : as far as i can see
toy : thinking of you
bmoc : big man on campus
121 : one to one
llgb : love, later, god bless
smop : small matter of programming
doei : goodbye
boe :  bind on equip
crat : cannot remember a thing
bffn : best friends for now
fyc : for your consideration
vip : very important person
ndn : indian
twita : that is what i am talking about
ns : nice set  no show
nato : no action talk only
sufi : super finger  shut up fucking imbecile
dewd : dude
d2 : dedos / fingers
aml : all my love
l2g : like to go?
tfx : traffic
b2c : business-to-consumer
hb : hurry back
brnc : be right back, nature calls
istr : i seem to remember
tbt : throwback thursday
grrlz : girls also seen as grrl
z% : zoo
ftbomh : from the bottom of my heart
bbsl : be back sooner or later
some1 : someone
eot : end of thread/text/transmission
dilligaf : do i look like i give a *freak*?
weg : wicked evil grin
^urs : up yours
g2g : got to go
unblefble : unbelievable
uwiwu : you wish i was you
wenja : when do you
bot : back on topic
lymi : love you mean it
mb : message board
sob : son of a b*tch
l/m : left message
og : original gangsta
mehh :  a sigh or sighing
2m2h : too much too handle
oaus : on an unrelated subject
uw : you are welcome
ssinf : so stupid it is not funny
jac : just a second
lmho : laughing my head off
bday : birthday
gtfooh : get the fuck out of here
mos : mom over shoulder
cnp : continued in next post
p/u : pick up
fil : father-in-law
vcda : vaya con dios amigo
iwiam : idiot wrapped in a moron
pth : prime tanning hours
fbi : fucking brilliant idea  female body inspector
bisflatm : boy, i sure feel like a turquoise monkey!
chk : check
pin : person in need  personal identification number
mra : moving right along
beos : nudge
lfti : looking forward to it
sxe : straight edge
tfs : thanks for sharing  three finger salute
lylc : love you like crazy
em : excuse me
oh : overheard
lsb : life sucks balls
tma : too many acronyms
im2bz2p : i am too busy to  pee
iyam : if you ask me
fubyoyo : fuck you buddy you are on your own
ltnt : long time no type
watn : where are they now
idk, my bff jill : i so not know my best friend forever jill
pix : pictures  photos
wuz : was
tys : told you so
w is^ : what is up?
nc : nice crib
pmigbom : put mind in gear before opening mouth
vff : very freaking funny
86 : out of over to get rid of or kicked out
ursktm : you are so kind to me
imo : in my opinion
yaba : yet another bloody acronym
bsod : blue screen of death
st&d : stop texting and drive
tp : team player  teleport  thanks pal  toilet paper
wddd : woopie doo da dey
jic : just in case
dhu : dinosaur hugs
iiwii : it is what it is
stppynozgtw : stop picking your nose get to work
twhab : this won't hurt a bit
abt2 : about to
yl : young lady
dhyb : so not hold your breath
adm : aye dios mio
hd : high definition
ianal : i am not a lawyer
dc : disconnect
otr : on the road
fsr : for some reason
d : dad   the
def : definitely
mia : missing in action
ef4t : effort
u : you
cpg : consumer packaged goods
teotwawki : the end of the world as we know it
l?^ : let is hook up
iccl : i could not care less
tilis : tell it like it is
wysilob : what you see is a load of bullocks
ut : unreal tournament
lthtt : laughing too hard to type
lylab : love you like a brother
swalk : sealed with a loving kiss
snif : simple nice index file
ltic : laughing 'til i cry
bio : bring it on
vim : very important member
pimp : peeing in my pants
craws : cannot remember anything worth a shit
2b@ : to be at
ykwycd : you know what you can do
bfn : bye for now
ywhol : yelling woohoo out loud
bbiam : be back in a minute
bak : back at keyboard
yhbw : you have been warned
pw : password
sadad : suck a dick and die
ssc : super sexy cute
solomo : social local mobile
swdyt : so what do you think?
jc : just curious  just chilling  jesus christ
aqap : as quick  as possible
yaotm : yet another off topic message
c&g : chuckle and grin
ugtbk : you have got to be kidding
rumcymhmd : are you on medication cause you must have missed a dose
gla : good luck all
hhoj : ha ha only joking
wilb : workplace internet leisure browsing
tmth : too much to handle
hu : hook up
cyoh : create your own happening
bruf : big requirements up front
nwal : nerd without a life
rusos : are you sos ?
tanj : there ain't no justice
fuw : fuck you world  fuck you weirdo
kippers : kids in parents' pockets eroding retirement savings
md : doctor of medicine  managing director
addy : address
cha : click here asshole
wtgp : want to go private?
@+ : french equivalent of cul8r
kok : knock
ao : anarchy online
2nite : tonight
re : regards  reply  hello again
tggtg : that girl guy has got to go
dfik : darn if i know
tyg : there you go  thank you god
nvng : nothing ventured nothing gained
sta : short term attitude
ylw : your loving wife
bm&y : between me and you
nidl : not interested dislike
jeomk : just ejaculated on my keyboard
*w* :  wink
thnx : thanks
inbd : it is no big deal
ama : ask me anything
rtfaq : read the faq
oirwis : oh i remember what i said
4 : for
ntl : nonetheless
buff : big ugly fat fuck
ford : found on road dead fixed or repaired daily fucked over rebuilt dodge
pwoms : parent watching over my shoulder
baby : being annoyed by you
tarfu : things are really fucked up
gtm : giggle to myself
durs : damn you are sexy
bbb : bye bye babe  boring beyond belief
smexi : combination of sexy and mexican, used to describe attractive people
2ez : too easy
nbfabs : not bad for a bot stopper
ytb : you are the best
411 : information
posslq : persons of the opposite sex sharing living quarters
ezy : easy
ufb : un *freaking* believable
lb?w/c : like bondage? whips or chains
usc : up shit creek
fay : fuck all y'all
hf : hello friend  have fun  have faith
*s* :  smile
ru/18 : are you over 18?
brl : belly roll laughs
m$ : microsoft
bms : baby making sex
fud : fear uncertainty and disinformation
wibni : wouldn't it be nice if
ru : are you?
rhip : rank has its privileges
dbmib : so not bother me i am busy
ywsyls : you win some, you lose some
iuss : if you say so
poahf : put on a happy face
fte : full time employee
ilf : i love female
shid : slap head in disgust
wan2tlk : want to talk
tbiu : the bitch is ugly
bco : big crush on
ai : artificial intelligence  as if
ymmv : your mileage may vary
iyfeg : insert your favorite ethnic group
twit : that is what i thought
nih : not invented here
joy : jesus first others second yourself last
ayec : at your earliest convenience
b2a : business-to-anyone
itfa : in the final analysis
sics : sitting in chair snickering
1ce : once
bump : bring up my post
lig : let it go
lmbao : laughing my black ass off
knim : know what i mean?
wot : waste of time or-  what
ilmj : i love my job
slap : sounds like a plan
twimc : to whom it may concern
ayw : as you were
gras : generally recognized as safe
icedi : i cannot even discuss it
peeps : people
aight : all right
hv : have
labatyd : life is a bitch and then you die
bag : busting a gut  big ass grin
fbc : facebook chat
wup : what is up?
ds : dear  son
aunt : and u know this
dltm : so not lie to me
rth : release the hounds
wdyt : what do you think?
hl : half life
piss : put in some sugar
wibamu : well i will be a monkey is uncle
rtrctv : retroactive
icw : i cannot wait
cwyl : chat with you later
n2mjchbu : not too much just chillin how bout you?
byoa : bring your own advil
etx : end of text
gqmf : gentleman is quarterly mother fucker
hbtu : happy birthday to you
cym : check your mail
ez : easy
dnpmpl : damn near pissed my pants laughing
tigas : think i give a shit
ycmu : you crack me up
iow : in other words
wtsds : where the sun so not shine
ntmu : nice to meet you
igtp : i get the point
imr : i mean really
iou : i owe you
nwr : not work related
wb : welcome back  write back
rmetth : rolling my eyes to the heavens
qfe : question for everyone
blnt : better luck next time
nmp : not my problem
no1 : no one
hig : how is it going?
bitfob : bring it the fuck on bitch
luk : good luck
phs : pointy haired stupidvisor
ggmsot : gotta get me some of that
aap : always a pleasure
huya : head up your ass
wafs : warm and fuzzies
morf : male or female
dlbbb : so not let  bed bugs bite
2nte : tonight
guvment : government also seen as guvmint gumint
gsyjdwurmnkh : good seeing you just so not wear your monkey hat
igp : i got to  pee
bod : benefit of the doubt  board of directors
embm : early morning business meeting
idst : i did not say that
adn : advanced digital network  any day now
hud : how you doing?
rw : real world
om : old man
fkm : fuck 'em
n/m : nothing much
dese : these
kb : kick butt
bbias : be back in a sec
nigyysob : now i've got you you son of a b*tch
ttg : time to go
dgt : so not go there
drb : dirty rat bastard
jff : just for fun
iyswim : if you see what i mean
bsaaw : big smile and a wink
bcoy : big crush on you
vgc : very good condition
55555 : crying your eyes out
op : on phone
hho1/2k : ha ha only half kidding
nak : nursing at keyboard
ihu : i hear you
wwnc : will wonders never cease
imheiuo : in my high exalted informed unassailable opinion
aota : all of the above
vgh : very good hand
gypo : get your pants off
wawi : what a wonderful idea
wd : well done
tlitbc : that is life in the big city
bmf : bad mother fucker
imjs : i am just saying
cul8r : see you later
rttsd : right thing to say dude
j4t or jft : just for today
lis : laughing in silence
bubu : slang term for the most beautiful of women
nme : enemy
ffs : for fuck sake
mhyf : move how you feel
emi : excuse my ignorance
ftc : failure to communicate
vnh : very nice hand
yarly : ya, really?
adip : another day in paradise
lmmfao : laughing my mother freaking ass off
hvh : heroic violet hold
zomg : used in world of warcraft to mean omg
cmu : crack me up
spoc : single point of contact
atc : any two cards
gr&d : grinning running & ducking
nos : new old stock  not outside sales
nnr : need not respond
doc : documet
fsbo : for sale by owner
neet : not currently engaged in employment education or training
yolo : you only live once
fol : fond of leather
lumu : love you miss you
4ever : forever
j00r : your
imsb : i am so bored
dynwutb : do you know what you are talking about?
ogim : oh god, it is monday
ebkac : error between keyboard and chair
ayt : are you there?
lbay : laughing back at you
nsisr : not sure if spelled right
dfwly : so not forget who loves you
iao : i am out
oicu812 : oh i see you ate one too
whydtm : what have you done to me?
bac : bad ass chick
afayc : as far as you are concerned
bmof : bite me old fart
ikr : i know right?
hadvd : have advised
ayce : all you can eat
aslmh : age/sex/location/music/hobbies
icwum : i see what you mean
pbiab : pay back is a bitch
wgaff : who gives a flying fuck
stbx : soon to be ex
suyf : shut up you fool
gsoas : go sit on a snake
daoc : dark age of camelot
2b or not 2b : to be or not to be
smt : something
gotdpwyd : get off the damn phone while you are driving
vwd : very well done
ytg : you are the greatest
glbt : gay lesbian bisexual transgender
p2c2e : process too complicated too explain
osintot : oh shit i never thought of that
c ya : see ya
iwbaptakyaiysta : i will buy a plane ticket and kick your ass if you say that again
pml : pissing myself laughing
idwtub : i so not want to upset you but
wtfwycm : why the fuck would you call me?
amf : adios mother fucker
mrph : mail the right place for help
c%l : cool
d&m : deep & meaningful
g : guess  grin  giggle
derp :  stupid or silly
csg : chuckle, snicker, grin
mtfbwy : may the force be with you
motos : member of the opposite sex
ppl : people  pay-per-lead  pay per lead
diik : darned if i know
fyf : from your friend
wywh : wish you were here
cid : consider it done  crying in disgrace
omg : oh my god
511 : too much information
np : no problem  nosy parents
urh : you are hot
lumtp : love you more than pie
bseg : big shit eating grin
idkabtt : i so not know about that
bhof : bald headed old fart
5fs : 5 finger salute
agb : almost good bridge
yatfm : you are too fucking much
fob : the name for a tool or form of id
feitctaj : *freak* 'em if they cannot take a joke
jtlyk : just to let you know
j/p : just playing
owtte : or words to that effect
wtfytt : who the fuck you talking to
qix : quick
obo : or best offer
fml : fuck my life
df : dear friend
yct : your comment to
tvm4yem : thank you very much for your e-mail
motss : member of the same sex
rmlb : read my lips baby
sowm : someone with me
wuwhima : wish you were here in my arms
dwh : during work hours
br : bathroom
tram : the rest are mine
llap : live long and prosper
wog : wise old guy
smim : send me an instant message
veg : vegetarian
t+ : think positive
eod : end of day  end of discussion
sfaiaa : so far as i am aware
^rup^ : read up please
iomh : in over my head
mwah :  kiss
afaic : as far as i am concerned
kwim : know what i mean?
siy : search inside yourself
tfys : the fuck you say
vn : very nice
iot : in order to
figjam : fuck i am good just ask me
igws : it goes without saying
gftd : gone for the day
mfwic : mother fucker who is in charge
ctc : care to chat  contact  choking the chicken
foag : fuck off and google
fasb : fast ass son bitchii
craft : cannot remember a fucking thing
ppppppp or 7p : prior proper planning prevents piss poor performance
enuf : enough
if/ib : in the front  in the back
icihicpcl : i cannot imagine how i could possibly care less
icyc : in case you are curious  in case you care
plokta : press lots of keys to abort
kyfc : keep your fingers crossed
nowl :  knowledge
j/o : jerking off
soddi : some other dude did it
slirk : smart little rich kid
hth : hope this  helps
pd : public domain
dyfm : dude you fascinate me
abbr :  abbreviation
b2b2c : business-to-business-to-consumer
c-t : city
w8 : wait
faql : frequently asked questions list
404 : i haven't a clue
dqydj : so not quit your day job
tilii : tell it like it is
gs : good shot
ftw : for the win  fuck the world
wlu2 : wicked love you too
obv : obviously
ipn : i am posting naked
asamof : as a matter of fact
atm : at the moment asynchronous transfer mode automated teller machine
udh82bme : you'd hate to be me
tq : te quiero / i love you
picnic : problem in chair not in computer
kos : kid over shoulder kill on sight
gtg : got to go
btwbo : be there with bells on
nagi : not a good idea
wayn : where are you now?
4nr : foreigner
mtf : more to follow
tas : taking a shower
dtk : down to kill
ftlog : for the love of god
tg : thank goodness
gab : getting a beer
nim : no internal message
imnerho : in my never even remotely humble opinion
rhk : roundhouse kick
chln : chilling
9 : parent is watching
fbm : fine by me
ntabom : now that is a bunch of malarkey
ntimm : not that it matters much
gge1 : good game, everyone
gbu : god bless you
oo : over and out
mwbrl : more will be revealed later
sm1 : someone
rtff : read the fucking faq
slt : something like that
tsb : tall sexy beautiful
hla : hola / hello
jja : just joking around
mrt : modified retweet
tbu : thinking about you
kotc : kiss on the cheek
mtfbwu : may the force be with you
fwb : friends with benefits
wgmgd : what get is measured get is done
orly : oh really?
zzz : sleeping bored tired
lol : laughing out loud
hmu : hit me up
wadi : what a dumb idea
tfti : thanks for the invitation
m4m : men for men  male for male
wbu : what about you?
lhk : love hugs kisses
cupl : couple
dnd : do not disturb
idgad : i so not give a damn
llta : lots and lots of thunderous applause
lusm : love you so much
adbb : all done bye bye
wthow : white trash headline of the week
nuff : enough
lysm : love you so much
wafm : what a fucking mess
tsnf : that is so not fair
jgmb : just google me b*tch
uds : ugly domestic scene
noyb : none of your business
impov : in my point of view
kit : keep in touch
ayv : are you vertical?
woof : well off older folks
dyjhiw : so not you just hate it when
fumf : fat ugly mother fucker
a/s/l/p : age/sex/location/picture
nycfs : new york city finger salute
81 :  hells angels
rkba : right to keep and bear arms
g1 : good one
ganb : getting another beer
p911 : parent alert
lolrotf&icgu : laughing out loud rolling on the floor & i cannot get up
isly : i still love you
wym : what do you mean?
inpo : in no particular order
itam : it is the accounting, man
ootd : one of these days
tmalss : to make a long story short
txs : thanks
ttyiaf : talk/type to you in a few
sooya : snake out of your ass
tbyb : try before you buy
fab : features attributes benefits
f2fmail : face-to-face mail
rimjs : really i am just saying
booms : bored out of my skull
sos : same old shit  help
thx : thanks
tx : thanks
thks : thanks
gyhooya : get your head out of your ass
yacc : yet another calendar company
kync : keep your nose clean
fu2 : fuck you too
gtsy : glad to see you
filth : failed in london try hong kong
esg : environmental social governance
nw : no way
bgwm : be gentle with me
pona : person of no account
mpfb : my personal fuck buddy
ddwi : so not dick with it
awttw : a word to the wise
jealz : jealous
ysdiw8 : why should i wait?
tilf : teacher i would like to fuck
uncrtn : uncertain
r&r : rest & relaxation
lola : laugh out loud again
mbrfn : must be real fucking nice
cya : cover your ass  see ya
brb : be right back
nd : no date
tyfc : thank you for charity
bfr : big fucking rock
pmf : pardon my french
fomc : fell off my chair
imgc : i might get caught
deti : so not even think it
uktr : you know that is right
h/o : hold on
s2r : send to receive
rnn : reply not necessary
smhid : scratching my head in disbelief
iha : i hate acronyms
mdiac : my dad is a cop
ic : independant contractor  in character  i see
amap : as many as possible  as much as possible
ygtbk : you have got to be kidding
*$ : starbucks
ywhnb : yes, we have no bananas
@ : at
galher : get a load of her
nnsh : night night sweet heart
mm : market maker  merry meet
dfl : dead *freaking* last
paw : parents are watching
wuciwug : what you see is what you get
cthu : cracking the *heck* up
kmria : kiss my royal irish arse
10x : thanks
arc : archive
cinba : clad in naught but air
nbd : no big deal
ygtbkm : you have got to be kidding me
eapfs : everything about pittsburgh fucking sucks
hag1 : have a good one
d00d : dude also seen as dood
sknkr : skincare
cfs : care for secret?
iswc : if stupid were a crime
tl;dr : too long; did not read
cye : check your email
llt : looks like trouble
ygwypf : you get what you pay for
bif : basis in fact  before i forget
dbd : so not be dumb
gb : good bridge
lulz : laughs or lulzsec
roflmao : rolling on floor laughing my ass off
wygiswypf : what you get is what you pay for
pb : potty break
wombat : waste of money brains and time
mubar : messed up beyond all recognition
witfits : what in the fuck is this shit
scuicht : so coked up i can hardly type
wtn : what then now?  who then now?
ttyt : talk to you tomorrow
to go nookleer : to explode
sex : sun users' group  all caps for sex
tnx : thanks
plu : people like us
b4yki : before you know it
vfm : value for money
sok : it is ok
ei : eat it
ianac : i am not a crook
fujimo : fuck you jack i am moving on
wytb : wish you the best
tdtm : talk dirty to me
fluid : fucking look it up i did
bioyiop : blow it out your i/o port
ykw : you know what?
sewag : scientifically engineered wild ass guess
cyt : see you tomorrow
ysk : you should know
unoit : you know it
bohica : bend over here it comes again
j2lyk : just to let you know
w00t : we own the other team
mstm : makes sense to me
sweet<3 : sweetheart
plz : please
pal : parents are listening  peace and love
ihtfp : i have truly found paradise  i hate this fucking place
lopsod : long on promises short on delivery
bl : belly laughing
ewi : e-mailing while intoxicated
crs : cannot remember shit
ct : cannot talk  cannot text
cre8 : create
ema : e-mail address
csa : cool sweet awesome
btfo : back the fuck off  bend the fuck over
usu : usually
bam : below average mentality
rsn : real soon now
bbn : bye, bye now
aytmtb : and you are telling me this because
nbif : no basis in fact
fwot : fucking waste of time
til : today i learned
cfy : calling for you
fpo : for placement only
qls : reply
wtt : want to trade?
bs : big smile  bull shit  brain strain
ight : i got high tonight
nism : need i say more
nagb : nearly almost a good bridge
shb : should have been
lh : laughing hysterically
ptpop : pat the pissed off primate
sufid : screwing up face in disgust
gt : good try
brt : be right there
lmbo : laughing my butt off
gbg : great big grin
rdv : reader is digest version
wai : what an idiot
lou : laughing over you
pwn : own
hp : higher power
ff&pn : fresh fields and pastures new
cx : cancelled
li : linkedin
cuol : see you online
lwos : laughing without smiling
zup :  what is up?
plo : peace love out
m8 : mate
dxnry : dictionary
twd : texting while driving
oc : original character  own character
gsc : gimme some credit
lgmas : lord give me a sign
el : evil laugh
pov : point of view
idunno : i so not know
inucosm : it is no use crying over spilt milk
azn : asian
omgyg2bk : oh my god, you got to be kidding
rfd : request for discussion
odtaa : one damn thing after another
loti : laughing on the inside
dmno : dude man no offense
dws : driving while stupid
aar8 : at any rate
beg : big evil grin
dmy : so not mess yourself
momboy : mamma is boy
wp : well played
dnbl8 : do not be late
btd : bored to death
rufkm : are you fucking kidding me?
cb : chat brat  coffee break -or call back
d/c : disconnected
7k : sick
lgbt : lesbian gay bisexual transgender
xme : excuse me
onl : online
xqzt : exquisite
b/w : between
swim : see what i mean?
sfttm : stop fucking talking to me
ttyl8r : talk to you later
shwaslomf : sitting here with a straight look on my face
h2cus : hope to see you soon
tcoy : take care of yourself
icfilwu : i could fall in love with you
acc : anyone can come
igyhtbt : i guess you had to be there
vbg : very big grin
asap : as soon as possible
esad : eat shit and die
onnta : oh no not this again
oln : online netiquette
747 : let is fly
kmsla : kiss my shiny little ass
mil : mother-in-law
aor : agency on record  album-oriented rock
wth : what the heck
alap : as late as possible
ili : i love it
aoyp : angel on your pillow
tabom : that is a bunch of malarkey
nsb : not sure but
rrr : har har har
pita : pain in the ass
snafu : situation normal all fucked up
llom : like leno on meth
icam : i could not agree more
know :  knowledge
w/ : with
bfflnmw : best friends for life, no matter what
sis : snickering in silence
ioud : inside outside upside down
ugtr : you got that right
ho : hang on  hold on
eg : example
sete : smiling ear to ear
galgal : give a little get a little
gmtaasdo : great minds think alike and so do ours
mhoty : my hat is off to you
nfg : not fucking good
dl : down low  download  dead link
suth : so use
somf : sit on my face
poets : piss off early tomorrow is saturday
btfldy : beautiful day
dtr : define the relationship
rmmm : read my mail man
tyl : text you later  thank you lord
pnatmbc : pay no attention to man behind the curtain
tcob : taking care of business
rt : real time  retweet
lyb : love you babe
lmtc : left a message to contact
rumorf : are you male or female?
ova : over
gmafb : give me a fucking break
tyvm : thank you very much
byod : bring your own device
wuu2 : what are you up to?
meh : who cares whatever
tftt : thanks for the thought
i1-d-r : i wonder
lykyamy : love you kiss you already miss you
tflms : thanks for letting me share
cbb : cannot be bothered
nfe : no fucking excuses
dttd : so not touch that dial
tlc : tender loving care
fiik : fuck if i know
fmuta : fuck me up the ass
n1 : nice one
ssewba : someday soon everything will be acronyms
tftc : thanks for the cache
werja : where do you
wylei : when you least expect it
pug : pick up group
nn : not now  need
sfb : shit for brains
fcol : for crying out loud
ftn : fuck that noise
eso : equipment smarter than operator
dgaf : so not give a fuck
fawomft : frequently argued waste of my fucking time
ugc : user-generated content
warez :  pirated  software
h9 : husband in room
hru : how are you?
gtgb : got to go bye
bbs : be back soon -or bulletin board service
tu : toes up
xd :  really hard laugh
g9 : genius
cua : see you around
yngbt : you are not gonna believe this
werru : where are you
emp : eat my pussy
2d4 : to die for
stfu : shut the fuck up
zmg or zomg : oh my god
10q : thank you
acorn : a completely obsessive really nutty person
coo : short for cool
cad : control + alt + delete
tyafy : thank you and *freak* you
nfws : not for work safe
wilco : will comply
rlco : real life conference
mompl : moment please
n2m : not to mention  not too much
fbf : fat boy food
sahm : stay at home mom
fum : fucked up mess
roflol : rolling on floor laughing out loud
figs : french italian german spanish
nth : nothing
topca : til our paths cross again
24/7 : twenty four seven all the time
aoc : available on cell
fttb : for the time being
sil : sister-in-law
dystsott : did you see the size of that thing
wah : working at home
mtbf : mean time before failure
dwi : driving while intoxicated
tir : teacher in room
sitd : still in the dark
afdn : any fucking day now
^5 : high five
iiabdfi : if it ain't broke so not fix it
k : ok
waef : when all else fails
rotflmao : rolling on the floor laughing my ass off
jj : just joking
curlo : see you around like a donut
puks : pick up kids
gigatt : god is good all the time
nss : no shit sherlock
bf : boyfriend
gic : gift in crib
es : erase screen
cuz : because
msg : message
fomcl : falling off my chair laughing
sfp : sorry for partying
esemed : every second every minute every day
tbc : to be continued
wuf : where you from
omaa : oh, my aching *a*
omik : open mouth insert keyboard
ambw : all my best wishes
mmha2u : my most humble apologies to you
yuppies : young urban professionals
sb : stand by
pvp : player versus player
tia : thanks in advance
u up : are you up?
w/e : weekend
alotbsol : always look on the bright side of life
wip : work in process
gmta : great minds think alike
iannngc : i am not nurturing the next generation of casualties
obtw : oh by the way
ifu : i fucked up
wiifm : what is in it for me
mego : my eyes glaze over
u2 : you too
bbr : burnt beyond repair
303 : mom
g2tu : got to tell u
cbj : covered blow job
ylh : your loving husband
cmb : call me back
iswym : i see what you mean
gigo : garbage in garbage out
lbr and lgr : little boy is room and little girl is room
tiail : think i am in love
abt : about
imi : i mean it
pnd : possibly not definitely  personal navigation device
ief : it is esther is fault
untco : you need to chill out
e2ho : each to his her own
gne1 : good night everyone
lyl : love you lots
gn : good night
lmkhtwofy : let me know how that works out for you
fgdai : fuhgedaboudit  forget about it
wiify : what is in it for you
idgaf : i so not give a fuck
tom : tomorrow
alw : ain't life wonderful
mejr : my eyes just rolled
x : times
yooper : someone from u.p.
iliciscomk : i laughed i cried i spat/spilt coffee/crumbs/coke on my keyboard
otw : off the wall  otherwise
ila : i love acronyms
sht : so hot
suac : shit up a creek
ur2k : you are too kind
gmba : giggling my butt off
spst : same place, same time
o4u : only for you
fysbigtbabn : fasten your seat belts it is going to be a bumpy night
bom : *b* of mine
vgn : vegan  vegetarian
gc : good crib
blkbry : blackberry
uv : unpleasant visual
cob : close of business
aise : as i said earlier
c4n : ciao for now
vbs : very big smile
swis : see what i am saying
bytm : better you than me
d8 : date
simyc : sorry i missed your call
afiniafi : a friend in need is a friend indeed
wx : weather
aweso : awesome
jhom : just helping out my
angb : almost nearly good bridge
swalbcakws : sealed with a lick because a kiss won't stick
dl : download
jw : just wondering
mla : multiple letter acronym
amof : as a matter of fact
imru : i am are you?
foot : fuck off over there  go away
oml : oh my lord
pxt : please explain that
lool : laughing outrageously out loud
mdr : mort de rire
alcon : all concerned
crit :  critical hit
n : no  and
dum : do you masturbate?
eom : end of message
ayfkmwts : are you fucking kidding me with this shit
gilf : grandmother i would like to fuck
as : ape shit  another subject
wyw : wish you well
rtss : read the screen stupid
doa : dead on arrival
ltm : laughing to myself
rfp : request for proposal
clab : crying like a baby
yumpi : young upwardly mobile professional idiot
tyclo : turn your caps lock off
afaict : as far as i can tell
ur2ys4me : you are too wise for me
ymal : you might also like
ciao : goodbye
qso : conversation
g2gicyal8er : got to go i will see you later
esadyfa : eat shit and die you fucking asshole
oatus : on a totally unrelated subject
vbmg : very big mischievous grin
tbe : thick between ears
ootc : obligatory on topic comment
byam : between you and me
abithiwtitb : a bird in the hand is worth two in the bush
fwiw : for what it is worth  forgot where i was
sul : snooze you lose
evo : evolution
crz : crazy
dgara : so not give a rat is ass
ofc : of course
wotam : waste of time and money
rus : are you serious?
ayc : are not you clever  are not you cheeky
ibrb : i will be right back
una : use no acronyms
eip : eggo is preggo
ack : acknowledgement
w9 : wife in room
t4bu : thanks for being you
adminr : administrator
c-p : sleepy
apac : asia-pacific
yd : yesterday
kol : kiss on cheek
a/n : author is note
wdyk : what do you know?
yryocc : you are running on your own cuckoo clock
bdn : big damn number
rtk : return to keyboard
wom : word of mouth  word of mouse
fbocd : facebook obsessive compulsive disorder
pyfb : pay your fucking bill
dtf : down to fuck
iluaaf : i love you as a friend
aih : as it happens
gggg : god god god god
sux : sucks
l@u : laughing at you  laughing about you
mbs : mom behind shoulder
stw : search the web
cd9 : code 9 -  parents are around
wh5 : who, what, when, where, why
ptmm : please tell me more
dk : so not know
pron : porn
ugfsu : your girlfriend is ugly
dis : did i say?
dw : so not worry
rfs : really fucking soon
oib : oh, i am back
n00b : newbie
tba : to be advised
acdnt : accident
a3 : anytime anyplace anywhere
ac : acceptable content
4eva : forever
rtbm : read the bloody manual
grobr : good riddance of bad rubbish
rtfq : read the fucking question
tpm : tomorrow p.m.
sub : shut up bitch
yttt : you telling the truth?
stst : sweet tea sweetie
pbb : parent behind back
koc : kiss on cheek
wys : whatever you say
wfm : works for me
wmpl : wet my pants laughing
b/g : background
gnblfy : got nothing but love for you
lho : laughing head off
syk : so you know
cf : coffee freak  cluster fuck
sig2r : sorry, i got to run
yb : you b*tch
4ao : for adults only
emfbi : excuse me for butting in
yby : yeah baby yeah
idrk : i so not really know
kitty : pussy
ntk : nice to know
dust : did you see that?
nblfy : nothing but love for you
ksc : kind  chuckle
seg : shit eating grin
tmwfi : take my word for it
ne1 : anyone
rtb : returning to base
nm : never mind  nothing much -or not much  nice move
ijwts : i just want to say
tfh : thread from hell
sdfb : smoke dope fuck b*tches
qtpi : cutie pie
fap : fucking a pissed
dui : driving under the influence
lwr : launch when ready
mva : motor vehicle accident
eq : everquest
dkp : dragon kill points
wit : wordsmith in training
ftf : fuck that is funny  face to face
utm : you tell me
keyme : key me when you get in
ntm : not that much
rgds : regards
moo : mud object-oriented  matter of opinion  my opinion only
aamof : as a matter of fact
woot : we own the other team
sm : senior moment
hay : how are you?
gafc : get a *freaking* clue
ggn : gotta go now
tntl : trying not to laugh
dic : drunk in charge
4q : fuck you
ssia : subject says it all
lls : laughing like *silly*
r u goin? : are you going?
ybs : you will be sorry
mfg : mit freundlichen gruessen
fwm : fine with me
wdys : what did you say?
lafw : listening  away from window
2b~not2b : to be or not to be
xyz : examine your zipper
sep : somebody else is problem
bfftte : best friends forever til the end
reso : reservation
bhg : big hearted guy  big hearted girl
noy : not online yet
ggoh : gotta get out of here
jp : just playing
iimad : if it makes any difference
ne : any
dgyf : damn girl you are fine
wdt : who does that?
crd : caucasian rhythm disorder  deficiency
fbfr : facebook friend
tui : turning you in
lgh : lets get high
ctfu : cracking the fuck up
yiu : yes i understand
rehi : hi again
smh : shaking my head
ayor : at your own risk
yic : yours in christ
abd : already been done
lylas : love you like a sister
ld : long distance  later dude
sbt : sorry about that
yt : you there?
fmtyewtk : far more than you ever wanted to know
kow : knock on wood
nt : nice try
gafyk : get away from your keyboard
trndo : tornado
bofh : bastard operator from hell
gnsd : good night sweet dreams
wru@ : where are you at?
gnoc : get naked on cam
lysyb : love ya see ya bye
byop : bring your own paint
wisp : winning is so pleasureable
oao : over and out
fwd : forward
1daful : wonderful
bmgwl : busting my gut with laughter
kfy : kiss for you
gwhtlc : glad we had this little chat
pen15 : it stands for penis
pwas : prayer wheels are spinning
ooh : out of here
ngl : not gonna  lie
luv : love
oi : operator indisposed
golf : grateful of lovely family  friends
afiaa : as far as i am aware
bro : be right over
ddsos : different day same old shit
jc  : just checking
nana : not now, no need
col : chuckle out loud  chortling out loud
soz : sorry
lg : life is good  long gone
2day : today
iaw : i agree with  in accordance with
2g2bt : too good to be true
gac : get a clue
anfawfos : and now for a word from our sponsor
myo : mind your own
bafo : best and final offer
gnight : good night
143 : i love you
su : shut up
lfm : looking for more
sop : standard operating procedure
lulu : locally undesireable land use
tfn : thanks for nothing  til further notice
cuwta : catch up with the acronyms
bioye : blow it out your ear
eva : ever
af : april fools
nrg : energy
crtla : cannot remember the three-letter acronym
uryy4m : you are too wise for me
tmi : too much information
xtc : ecstasy
wckd : wicked
gtasc : going to a strip club
m4c : meet for coffee
ydkm : you so not know me
ifyp : i feel your pain
hago : have a good one
bbl : be back later
aka or a.k.a. : also known as
a/s/l : age/sex/location
barb : buy abroad but rent in britain
msmd : monkey see monkey do
gff : go fucking figure
wati : what a terrible idea
gd&r : grinning ducking and running
app : application
bcbs : big company big school
wwyc : write when you can
sk8ng : skating
rx : regards
l8r : later
news : north east west south
ngh : not gonna happen
ufuf : you fuck you fix
gud : geographically undesirable
g/f : girlfriend
faak : falling asleep at keyboard
trp : television rating points
gtfo : get the fuck out
tou : thinking of you
2dloo : toodle oo
ruok : are you ok?
dnt : so not
ri&w : read it and weep
sme : subject matter expert
bau : business as usual
otfl : on the floor laughing
wg : wicked grin
wtmc : what the mother c***
gi : google it
imho : in my humble opinion
q4u : question for you
rofl : rolling on floor laughing
poof : i am gone
fs : for sale
gagfi : gives a gay first impression
snert : snotty nosed egotistical rotten teenager
itsfwi : if the shoe fits wear it
wca : who cares anyway
bka : better known as
wts : want to sell
pwms : playing with myself
oj : only joking
irmc : i rest my case
dgtg : so not go there girlfriend
wmmows : wash my mouth out with soap
pmsl : pissed myself laughing
wttm : without thinking too much
ia8 : i already ate
mnc : mother nature calls
iydmma : if you so not mind my asking
kutgw : keep up the good work
hot pic : hot picture as in sexy or naked
swf : single white female
1337 : elite leet l337
nev : neighborhood electric vehicle
wtfgda : way to fucking go dumb ass
tinwis : that is not what i said
taw : teachers are watching
der : there
